
   ▄   ██   █▄▄▄▄ ██▄   ▄█    ▄   ██     ▄▄▄▄▀ ████▄ █▄▄▄▄     
    █  █ █  █  ▄▀ █  █  ██     █  █ █ ▀▀▀ █    █   █ █  ▄▀     
██   █ █▄▄█ █▀▀▌  █   █ ██ ██   █ █▄▄█    █    █   █ █▀▀▌      
█ █  █ █  █ █  █  █  █  ▐█ █ █  █ █  █   █     ▀████ █  █      
█  █ █    █   █   ███▀   ▐ █  █ █    █  ▀              █       
█   ██   █   ▀             █   ██   █                 ▀        
        ▀                          ▀                           

